1011111111111
1010000000001
1010000000001
1011111110001
1000000010001
1111111010001
1000001010001
1000001010001
1000001010001
1000001010001
1000001010001
1000010010001
1000100100001
1000101000001
1111101111111